rows: 32
cols: 48

cells:
  - '################################################'
  - '#..............................................#'
  - '#..............................................#'
  - '#...........xxxxxxxxxxxxxxxxxxxxxxxxx..........#'
  - '#...........xxxxxxxxxxxxxxxxxxxxxxxxx..........#'
  - '#...........xxxxxxxxxxxxxxxxxxxxxxxxx..........#'
  - '#...........xxx...................xxx..........#'
  - '#...........xxx.##.##.##.##.##.##.xxx..........#'
  - '#...........xxx.##.##.##.##.##.##.xxx..........#'
  - '#...........xxx...................xxx..........#'
  - '#...........xxx.##.##.##.##.##.##.xxx..........#'
  - '#...........xxx.##.##.##.##.##.##.xxx..........#'
  - '#...........xxx...................xxx..........#'
  - '#...........xxx.##.##.##.##.##.##.xxx..........#'
  - '#...........xxx.##.##.#...#.##.##.xxx..........#'
  - '#...........xxx.........@.........xxx..........#'
  - '#...........xxx.##.##.#...#.##.##.xxx..........#'
  - '#...........xxx.##.##.##.##.##.##.xxx..........#'
  - '#...........xxx...................xxx..........#'
  - '#...........xxx.##.##.##.##.##.##.xxx..........#'
  - '#...........xxx.##.##.##.##.##.##.xxx..........#'
  - '#...........xxx...................xxx..........#'
  - '#...........xxx.##.##.##.##.##.##.xxx..........#'
  - '#...........xxx.##.##.##.##.##.##.xxx..........#'
  - '#...........xxx...................xxx..........#'
  - '#...........xxxxxxxxxxxxxxxxxxxxxxxxx..........#'
  - '#...........xxxxxxxxxxxxxxxxxxxxxxxxx..........#'
  - '#...........xxxxxxxxxxxxxxxxxxxxxxxxx..........#'
  - '#..............................................#'
  - '#..............................................#'
  - '#..............................................#'
  - '################################################'

